%%%%%%%%%%%%
%.% %  %P  %
%   %      %
%%      %  %
%%%%%%%%%%%%