%%%%%%%%%%%%%%%%%%%%%%%%%%%%%%%%%%%%%%%%%%%%%
%                                          P%
%    ....      .       .      .        .    %
%    .  .     . .      .      . .     ..    %
%    ....    .....     .      .  .   . .    %
%    .      .     .    .      .   . .  .    %
%    .     .       .   ....   .    .   .    %
%                                           %
%%%%%%%%%%%%%%%%%%%%%%%%%%%%%%%%%%%%%%%%%%%%%